###################################################################
#                                                                 #
#                                                                 #
#                                                                 #
#                                       #                         #
#                                       #                         #
#                                       #                         #
#                                       #                         #
#                                       #############             #
#                                       #                         #
#                                       #                         #
#                                       #                         #
#                                       #                         #
#                                       #                         #
#                                       #                         # 
#                                       #                         #
#        ################################   Z                     #
#                                       #                         #
#                                       #                         #
#                                       #                         #
#                            S          #                         #
#                                       #                         #
#        ################################                         #                         
#                                                                 #
#                                                                 #
###################################################################
