##########
#   #    #
#   ##   #
# #Z#  ###
# ## #   #
#   S #  #
#     #  #
#        #
##########
