###################################################################
#                                                                 #
#                                                                 #
#                                                                 #
#                                                                 #
#                                                                 #
#                                                                 #
#                                                                 #
#                                                                 #
#                                                                 #
#                                                                 #
#                           #                                     #
#S                          #                                    Z#
#                           #                                     #
#                                                                 # 
#                                                                 #
#                                                                 #
#                                                                 #
#                                                                 #
#                                                                 #
#                                                                 #
#                                                                 #
#                                                                 #                         
#                                                                 #
#                                                                 #
###################################################################